########################################
#............#..............#..........#
#......#####.#..............#..........#
#......#####.#..............#####.######
#......#####.#.........................#
############.##########..########.######
#....#######.##########...#............#
#....#............###.....#............#
#....#............###.....#............#
######....................##############
#.................###.....#............#
#.................###..................#
#.................###.....#............#
########################################
